##########
##########
##########
###*######
##########
#*########
#@$   .###
##########
##########
##########
