##########
##########
#@*###  ##
#  ### $##
# $ ##  ##
# .      #
#####.   #
#####  ###
##########
##########
