##########
##########
#   ######
#  $  $ .#
#  ## ####
#   . ####
####  ####
####@*####
##########
##########
