##########
##########
##  ######
##V  #####
#### #####
#    .####
# $@  ####
#  #######
##########
##########
