##########
##########
##########
##########
#      ###
# *@$#  ##
#   . $ ##
#.    ####
##########
##########
