##########
#. $ .####
####  ####
##### ####
#####$####
#  ## ####
#$    ####
#+ #######
##########
##########
