##########
#@$ . V###
#   # ####
###   ####
###  #####
#### #####
#### #####
###    ###
###  V ###
##########
