##########
###### * #
######   #
##*### ###
#####. $@#
##########
##########
##########
##########
##########
